11111111111111111111111111111111111111111
10000C00000000000000000000000000000000001
10000011111110000000000001111110000001001
100000000000100000000C0000000011111111001
10000000000C10000000000000000010000001001
10000000000010000000000000000010001000001
11111110000010000001111111111110001000001
1000000000001000P000000000000000001000001
10000000000010000000000000000000001000001
1000000000001000000000C001000001111100001
100000000000100000000010000000010E0100001
1000000000001000000000100C000001000100001
10000C0000000000C000001000000011000100001
10000000001111111111111011111110000100001
10000000000000000000001000000010000100001
10000000000000001111111011111110000100001
10000000000000000000000C10000010011111101
100000C000000000000000001000001000001C001
10000000000000000000000010000010000010001
100000000000000000000000000000100C0000001
11111111111111111111111111111111111111111