11111111111111
10P00000000001
10000000000001
10000000000001
10000000000001
11111111111111