11111111111111111111111111111111111111111
10P00000000000000000000000000000000000001
10000000000010000000000000000010000000001
100000000000100000000C0000000010000000001
10000000000010000000000000000010000000101
10000000000010000000000000000010000000001
10000000000010000001111111111110000000001
10000000000010000000000000000000000000001
10000000000010000000000000000000001000001
1000000000001000000000C001000000000000001
100000000000100000000000000000000E0000001
1000000000001000000000000C000000000000001
1000000000000000C000000000000010000000001
10000000000000000000000100000010000000001
10000000000000000000000000000010000000001
10000000000000001000000000000010000000001
10000000000000000000000C0000001000000C011
10000000000000000000000000000010000000001
100000000000000000000000000000100000C0001
10000000000000000000000000000010000000001
11111111111111111111111111111111111111111