1111111111111111111111111111111111111111111111111111111
1X00000000000100000000000000000000000000000100000100E01
100000000C1111000000000000000000C0000100000100000100001
1000000000000000000001000000000011111111111100000000001
11111100000000000000010000000000000001000000000C0000001
1000P10000000000000001000000000C00000000000100000110C01
1000010000001111111111000000000000000100000100000110001
10C0000000000000010000000000000000000111111100000000001
1000000000000000000000000000000CC0000000000000000000001
1111111111111111111111111111111111111111111111111111111