111111111111111111111111111111111111111111111111111
100000000000000000000000000000000000000000000000001
100000111111100000000000011111100000010000000000001
100000000000100000000000000000111111110000C000C0001
100000000000100000000000000000100000010000000000001
1000000C0000100000000000000000100010000000000000001
111111100000100000011111111111100010000000000000001
100000000000100000000000000000000010000000000001111
1000000000001000000000000000000000100000000C0000001
100000000000100000000000010000011111000000000000001
100000000000100000000010000000010E01000000000010001
100P000000001000C0000010000000010001000000000010001
100000000000000000000010000000110001000000000010001
10000010001111111111111011111110000100000000C010001
1000001000000000000000100000001000010C0000000010001
100000100000000011111110111111100001000000000010001
100000100000000011111110111111100001000000000010001
10000010000000000000000010000010011111100000C010001
1000000000000000000000X0100000100000100000000010001
10000C000000000000000000100000100000100000000010001
10000C00000000000C00000000000010000000000C000010001
100000000000000000000000000000100000000000000010001
100000000000000000000000000000100000000000000010001
111111111111111111111111111111111111111111111111111