1111111111111111111111111111111111111111111111111111111
10000010000000000C000000000000000010000C00000001000E001
1000011011111111100111100C00001100000000001000010000001
1000000000010000000100000000000000111110001000000101101
100000110001C000000100000000000000000010001001100100001
100100100000000000011100C000001000000010001000000100111
100100001000000010000000011111100011111111100000010C001
100000001000000010000000C000000000000000000000000000001
10000C00100000001000000001000000C000000C000001111100001
1000000010001111100000000100000011100001000100000000001
10000P001000000000100C00010000000000000100010000C000001
1000011010000001001000C00000000000100000000C00001000001
100001000000000110000000000000000010000C000000001000001
10110000001000001111111111111X0000100000100001111111001
100000000000000000000000C0000000C0000000100000000000001
1111111111111111111111111111111111111111111111111111111