1111111111111111111111111111111111111111111111111111110
10P0000000000000X000000E0000000000000000000000000000001
1000000000000000000000000000000000000000000000000000001
1000000000000000C00000000000000000000000000000000000001
1000000000000000000000000000000000000000000000000000001
1000000000000000000000000000000000000000000000000000001
1000000000000000000000000000000000000000000000000000001
1000000000000000000000000000000000000000000000000000001
1000000000000000000000000000000000000000000000000000001
1111111111111111111111111111111111111111111111111111111